RRRRRRRRRRRRRRRRRRRR
RGGGGGGGGGGGGGGGGGGR
RGRRRGFRGGGRGGGRRRGR
RGGGGGGRGGGRGGGGGGGR
RGRRGRRRGGGRRRGGRRGR
RGRRGGGGGGGGGGGGRRGR
RGGGGGRRRRRRRRGFGGGR
RRRRGGGGGGGGGGGGRRRR
RGGGGGRGGGGGGRGGGGGR
RGRRRRRGGRRGGRRRRRFR
RGGFGGGGRRRRGGGGGGGR
RRRRRRRRRRRRRRRRRRRR
