TTTTTTTTTTTTTTTTTTTT
LSSSSSSSSSSSSSSSCSSR
LSSSSSSSSSCSSSSSSSSR
LSSSCSSSSSSSSSSSSSSR
LSSSSSSSSSSSSSSSSSSR
LSSSSSSSSSSSSSSSSSSR
LSSSSSSSSSCSSSSCSSSR
LSSSSSSSSCSCSSSSSSSR
LSSSSSSSSSCSSSSSSSSR
LSSSCSSSSSSSSCSSSSSR
LSSSSSSSSSSSSSSSSSSR
BBBBBBBBBBBBBBBBBBBB
