WWWWWWWWWWWW
W        X W
W   P   WWWW
W          W
WWWWWWW    W
W  X WW    W
W    WW    W
W          W
W       BB W
W       W  W
WWWWWWWWWWWW
